#########
#********
#e*******
#*u#*****
#**#*****
#e***#***
#******#*
#******#*
#***#****
#********
##*******
#***#****
#********
#********
#e*******
#**#*****
#**#*****
#****#e**
#******#*
#******#*
#***#****
#********
#********
#e**#****
#********
#E*******
#********
#**#*****
#**#*****
#****#***
#******#*
#******#*
#***#****
#********
#****#w**
#########