#********
#********
#********
#*u#*****
#**#*****
#****#***
#******#*
#******#*
#***#****
#********
#********
#***#****
#********
#********
#********
#**#*****
#**#*****
#****#***
#******#*
#******#*
#***#****
#********
#********
#***#****
#********
#********
#********
#**#*****
#**#*****
#****#***
#******#*
#******#*
#***#****
#********
#********
#***#****